R 1920 1080
NO textures/north.xpm
SO textures/south.xpm
WE textures/east.xpm
EA textures/west.xpm
S textures/loveniel.xpm
F 245, 212, 198
C 163, 238, 255


1111111111111111111111111111111111
1000000010000000010000000100000001
1000000010000000000000000100000001
1000000010000000010000000100000001
1111011111110111111110111110111111
10000000000000000100000000000000001
100000000000000001000000000000000001
1111111000000000000000000000000000001
10000000000010011111111110000000000001111
10000000000010010000000010000000000000001
100000S0000010010000000010000000000010001
10000000000200010000000011000000000110001
10000022000000010000000012000000001110001
10000000000000001111001111111111111110001
10000000000000000000000000000000011110001
10000000000000000000000000000000011110001
11111111100111111111111111111111111110001
        1001                        10001
        1001                        10001
        1001                        10001
        1001                        10001
        1001                        10001
        100111111111111111111111111110001
        100000000000000000000000000000001
        100000000000000000000000000000001
        111111111111111111111111111111111

