R 1920 1080
NO ./path_to_the_north_texture
SO ./path_to_the_south_texture
WE ./path_to_the_west_texture
EA ./path_to_the_east_texture
S ./path_to_the_sprite_texture
F 220,100,0
C 225,30,0
        1111111111111111111111111
        1000000000110000000000001
        1011000001110000002000001
        1001000000000000000000001
111111111011000001110000000000001
100000000011000001110111110011111
111101111111110111000000100011111
111101111111110111010100100011111
1100000011010111110000001000111
100020000000000011000000100011
100000000000000011010100100001
11000001110101011111011110N011
11110111 1110101 101111010001
11111111 1111111 111111111111
