NO textures/north.xpm
SO textures/south.xpm
WE textures/east.xpm
EA textures/west.xpm
C 163, 238, 255
F 245, 212, 198   


111111111111111111111111111111
11111111100000000000000011111
100000000000000000111000100001
110000100000000000000000001111
100001111111000000001111111
1111111000000000W000000000001
11110000000000110000000000011
110000000000011110000000000011
100000000000111000000000000011
110000000000111000000000001111
110000000001111000000000000111
111111111111111111111111111111111
111111111111111111111111111111111
111111111111111111111111111111111

