
NO textures/north.xpm
SO textures/south.xpm
WE textures/east.xpm
EA textures/west.xpm

F 255, 210, 137
C 215, 89, 255

111111111111111111111111111111111111111111111111111111111111
11111111100000000000000011111111111111111111111111111111111
110000100000000000000000001111
1000011111110000000011111111
1111111000000000E000000000001
11110000000000110000000000011
110000000000011110000000000011
100000000000111000000000000011
110000000000111000000000001111
110000000001111000000000000111
111111111111111111111111111111111
111111111111111111111111111111111
111111111111111111111111111111111

